11  10  10  10  10  10  10  10  10  10  10  10  10  10  10  10  10  01  01
03  01  01  06  01  06  01  01  06  1D  1E  01  01  01  01  01  01  01  01
15  01  06  01  01  01  01  01  01  2A  2B  0A  02  02  02  02  02  0B  01
15  06  01  01  01  06  0A  02  02  02  02  04  06  11  10  10  10  03  01
15  01  01  0A  02  02  04  1D  1E  01  01  03  01  15  0A  02  02  04  01
15  01  01  03  01  01  03  2A  2B  01  06  03  01  15  03  01  01  03  01
15  06  01  0D  02  02  05  02  02  02  02  0C  01  15  03  01  01  03  01
15  01  01  06  1B  1C  03  1B  1C  1B  1C  1D  1E  15  03  01  01  03  01
15  01  01  06  28  29  03  28  29  28  29  2A  2B  15  03  01  01  03  01
13  10  10  10  10  12  03  11  10  10  10  10  10  14  03  01  01  03  01
10  10  10  10  10  14  08  02  02  02  02  09  02  02  05  02  02  0C  01
06  01  01  01  1D  1E  03  1D  1E  1D  1E  03  1D  1E  03  01  01  01  01
06  06  06  06  2A  2B  03  2A  2B  2A  2B  03  2A  2B  03  01  01  01  01
06  06  06  06  06  06  0D  02  02  02  02  07  02  02  0C  01  01  01  01
06  06  06  06  06  06  06  06  06  06  06  06  06  06  01  01  01  01  01
01  01  01  01  01  01  01  01  01  01  01  01  01  01  01  01  01  01  01
01  01  01  01  01  01  01  01  01  01  01  01  01  01  01  01  01  01  01
