12  11  11  11  11  11  11  11  11  11  11  11  11  11  11  11  11  11  11  11  11
16  01  01  0F  01  01  0F  0F  01  1E  1F  01  0F  0F  01  01  0F  01  01  01  01
16  0F  01  01  0F  0F  01  01  01  20  21  18  18  17  17  17  18  18  17  17  01
16  0F  01  0F  01  01  17  18  17  18  17  17  06  12  11  11  23  17  01  17  01
16  01  01  17  17  18  17  19  1B  1E  1F  18  06  16  17  17  18  18  01  18  01
16  01  01  18  01  01  18  1C  1D  1C  1D  17  06  16  17  01  01  18  01  17  01
16  0F  01  17  18  17  17  18  17  17  18  17  06  16  18  0F  0F  17  01  17  01
16  01  01  01  1E  1F  17  06  06  06  1E  1F  06  16  18  01  0F  18  01  17  01
16  01  0F  0F  20  21  18  0F  0F  0F  20  21  06  16  17  0F  01  18  01  17  01
16  0F  01  01  0F  0F  17  0F  0F  0F  0F  0F  0F  16  18  01  01  17  01  18  01
14  11  11  11  11  11  18  11  11  11  11  11  11  15  17  18  18  18  17  18  01
06  01  01  01  19  1B  18  17  18  17  18  17  18  17  17  01  01  01  01  01  01
06  06  06  06  1C  1D  18  19  1B  0F  06  0F  19  1B  17  01  0F  01  0F  01  01
06  06  06  06  06  06  17  1C  1D  0F  06  0F  1C  1D  18  01  0F  01  01  01  01
06  06  06  06  06  06  18  17  17  17  17  17  17  18  18  01  01  0F  01  0F  01
0F  0F  01  0F  01  0F  01  01  01  0F  01  01  01  01  01  0F  01  01  01  01  01
01  0F  01  01  01  01  01  0F  01  01  01  0F  01  0F  01  01  01  01  0F  01  0F
